17
30
********* ********************
*                            *
********** *     ********* * *
*           *    *   *   * * *
*********** *    * * * * * * *
*            *   * * * * * * *
************ *   * * * * * * *
*             *  * * * * * * *
************* *  * * * * * * *
*              * * * * * * * *
************** * * * * * * * *
*                * * * * * * *
***************  * * * * * * *
*                * * * * * * *
**************** * * * * * * *
*                  *   *   * *
**************************** *
