6 15
*** ***********
*             *
*             *
*             *
*             *
************ **

