16
50
********************* ****************************
********                             **          *
********** ********** ************** ** ******* **
********** ********** **************    ******* **
******                ******     *** ******   * **
****** *** ***************** *** *** ******* *  **
**     *** ***************** *** *** ******   * **
** *******        **         *** *** ****** * * **
**    **** ****** ** *********** ***      * * * **
***** **** ******    *******     **  ** * * * * **
***** ****    ************** ******* ** * * * * **
***** ******* **************         ** * * * * **
***** ******* ************************* * * * * **
*****         *****************         * * * * **
******************************* *******     *   **
*************************************** **********
